
MAZE: "mylevel", ' '
FLAGS:hardfloor
INIT_MAP: solidfill,' '
GEOMETRY:center,center
MAP
...............
...............
...............
...............
...............
...............
...............
...............
...............
...............
...............
...............
...............
...............
...............
ENDMAP
REGION:(0,0,15,15),lit,"ordinary"
WALLIFY
MONSTER:"giant bat",random
MONSTER:"kobold",random
OBJECT:('!',"full healing"),random
